# Resources from graph.properties
alreadyConnected=Nodes already connected
cancel=取消
close=关闭
containsValidationErrors=Contains validation errors
done=Done
doubleClickOrientation=Doubleclick to Change Orientation
error=错误
errorSavingFile=保存文件时出错
ok=OK
updatingDocument=Updating Document. Please wait...
updatingSelection=Updating Selection. Please wait...
# Custom resources
about=关于
actualSize=Actual Size
add=添加
addLayer=添加图层
addProperty=新增属性
addToExistingDrawing=添加到现有的图中
addWaypoint=添加锚点
advanced=高级
align=对齐
alignment=Alignment
allChangesLost=所有更改都将丢失!
angle=角度
apply=应用
arc=弧
arrange=布局
arrow=箭头
arrows=箭头
automatic=自动
autosave=自动保存
autosize=自动调整
back=返回
background=背景
backgroundColor=背景色
backgroundImage=背景图
basic=基本
block=Block
blockquote=块引用
bold=粗体
border=边框
borderWidth=边框宽度
borderColor=边框颜色
bottom=底
bottomAlign=向下对齐
bottomLeft=左下
bottomRight=右下
bulletedList=项目符号列表
cannotOpenFile=无法打开文件
center=居中
change=更改
changeOrientation=无法打开文件更改方向
circle=圆形布局
classic=经典
clearDefaultStyle=清除默认样式
clearWaypoints=清除曲线锚点
clipart=本地图库
collapse-expand=折叠/展开
collapse=折叠
collapseExpand=折叠/展开(默认选中)
collapsible=可折叠
comic=手绘
connect=Connect
connection=连接
connectionPoints=连接点
connectionArrows=连接箭头
constrainProportions=固定比例
copy=拷贝
copyConnect=连接时拷贝
copySize=拷贝尺寸
create=Create
curved=曲线
custom=自定义
customZoom=自定义缩放
cut=剪切
dashed=虚线
decreaseIndent=减少缩进
default=默认
bindingDeviceId=绑定设备
bindXMLName=绑定XML文件
delete=删除
deleteColumn=删除列
deleteRow=删除行
diagram=图表
diamond=菱形
diamondThin=菱形 (thin)
direction=方向
distribute=等距分布
divider=分频器
documentProperties=文件属性
dotted=点缀
dpi=分辨率
drawing=绘制{1}
drawingEmpty=绘制为空
drawingTooLarge=绘制太大
duplicate=复制
duplicateIt=复制{1}
east=向右
edit=编辑
editData=编辑数据
editDiagram=编辑图形
editImage=编辑图片
editLink=编辑链接
editStyle=编辑样式
editTooltip=编辑提示文字
enterGroup=进入编辑组
enterValue=输入值
enterName=输入名称
enterPropertyName=输入属性名称
entityRelation=实体关系
exitGroup=退出编辑组
expand=展开
export=导出
extras=其它
previousStep=返回上一步的XML
file=文件
fileNotFound=文件未找到
filename=文件名
fill=填充
fillColor=填充色
fitPage=整页显示
fitPageWidth=适应页面宽度
fitTwoPages=双页
fitWindow=适应视窗大小
flip=翻转
flipH=水平翻转
flipV=垂直翻转
fullScreen=全屏
font=字体
fontFamily=字体系列
fontColor=字体颜色
fontSize=字体大小
formatBlock=格式块
format=格式
formatPanel=格式面板
general=Allgemein
formatPdf=PDF
formatPng=PNG
formatGif=GIF
formatJpg=JPEG
formatSvg=SVG
formatXml=XML
formatted=格式化
formattedText=格式化文本
gap=Gap
glass=滤镜
general=通用
global=全局
gradient=渐变
gradientColor=渐变颜色
grid=网格
gridSize=网格大小
group=组合
guides=参考线
heading=标题
height=高度
help=帮助
hide=隐藏
hideIt=隐藏 {1}
hidden=Hidden
home=首页
horizontal=水平
horizontalFlow=水平布局
horizontalTree=水平树状布局
html=HTML
id=ID
image=图片
images=Images
import=导入
increaseIndent=增加缩进
insert=插入
insertColumnBefore=向左插入列
insertColumnAfter=右插入列
insertFreehand=插入自由绘制
freehand=自由绘制
insertHorizontalRule=插入水平标尺
insertImage=插入图片
insertLink=插入链接
insertRowBefore=在上面插入行
insertRowAfter=在下面插入行
invalidInput=无效输入
invalidName=名称为空/无效名称
invalidOrMissingFile=无效或丢失的文件
isometric=等尺寸
italic=斜体
layers=图层
landscape=横向
laneColor=柠檬色
layout=布局
left=左
leftAlign=左对齐
leftToRight=从左至右
line=线型
link=链接
lineJumps=换行
lineend=线末端
lineheight=线高
linestart=线始端
linewidth=线宽
loading=加载标题
lockUnlock=锁定/解除锁定
manual=手册
middle=垂直居中
misc=杂项
modificationNotSavedClickHereToSave=修改未保存,点击此处保存.
allChangesSaved=所有修改已保存
more=More
moreResults=More Results
move=Move
moveSelectionTo=将所选移至{1}
navigation=导航
new=新建
noColor=No Color
noFiles=No files
noMoreResults=No more results
none=无
noResultsFor=No results for '{1}'
normal=正常
north=向上
numberedList=编号列表
opacity=不透明度
open=Open
openArrow=Open Arrow
openFile=Open File
openLink=打开链接
openSupported=Supported format is .XML files saved from this software
openInNewWindow=在新窗口中打开
openInThisWindow=在此窗口中打开
options=选项
organic=自动布局
orthogonal=正交
outline=缩略图
oval=Oval
pages=页码
pageView=页面视图
pageScale=页面比列
pageSetup=页面设置
panTooltip=按住空格键并拖拽以移动画布
paperSize=页面尺寸
paste=粘贴
pasteHere=粘贴到此处
pasteSize=粘贴大小
pattern=样式
perimeter=边距
placeholders=记住此设置
plusTooltip=单击进行连接与复制(ctrl+单击进行复制, shift+单击进行连接). 拖拽进行连接 (ctrl+拖拽进行复制).
portrait=纵向
position=位置
posterPrint=打印海报
preview=预览
print=打印
radialTree=径向树状布局
redo=重做
removeFormat=清除格式
removeFromGroup=从组合中移出
removeIt=删除背景
removeWaypoint=移除锚点
rename=重命名
renameIt=Rename {1}
replace=更换
replaceIt={1} already exists. Do you want to replace it?
replaceExistingDrawing=更换现有的图
reset=重置
resetView=重置视图
reverse=翻转
right=右
rightAlign=向右对齐
rightToLeft=由右至左
rotate=旋转
rotateTooltip=Click and drag to rotate, click to turn shape only by 90 degrees
rotation=旋转
rounded=圆角
saveTopo=保存TOPO图
save=保存
saveAs=另存为
saved=已保存
scrollbars=滚动条
scratchpad=素材库
search=搜索
searchShapes=搜索图形
selectAll=全选
selectEdges=选择边
selectFont=选择字体
selectNone=全不选
selectVertices=选择顶点
setAsDefaultStyle=设置为默认样式
shadow=阴影
shape=形状
sharp=尖角
sidebarTooltip=单击以展开,将图形拖拽至图表中。Shift+单击以改变所选内容, Alt+单击以插入及连接。
simple=简单
simpleArrow=简单箭头
size=大小
solid=固体
sourceSpacing=Source Spacing
south=向下
spacing=间距
startDrawing=开始绘制
stopDrawing=结束绘制
straight=直线
strikethrough=删除线
strokeColor=线条颜色
style=样式
subscript=下标
superscript=上标
table=表格
targetSpacing=Target Spacing
text=文本
textAlignment=Text Alignment
textOpacity=Text Opacity
toBack=置于底层
toFront=置于顶层
toggleRounded=切换
tooltips=提示
top=顶
topAlign=向上对齐
topLeft=左上
topRight=右上
transparent=透明
turn=旋转90°/翻转
uml=建模
underline=下划线
undo=撤销
ungroup=取消组合
url=URL
untitledLayer=Untitled Layer
vertical=垂直
verticalFlow=垂直布局
verticalTree=垂直树状布局
view=视图
viewPanels=视图面板
viewZoom=视图缩放
waypoints=锚点
west=向西
width=宽度
wordWrap=自动换行
writingDirection=书写方向
zoom=缩放
zoomIn=放大
zoomOut=缩小

# customize
electrics=电学